"a" = (/turf/template_noop,/area/template_noop)
"b" = (/turf/closed/mineral,/area/lavaland/surface/outdoors)
"c" = (/turf/open/floor/plating/asteroid/basalt/lava_land_surface,/area/lavaland/surface/outdoors)
"d" = (/obj/item/circlegame,/turf/open/floor/plating/asteroid/basalt/lava_land_surface,/area/lavaland/surface/outdoors)
"e" = (/obj/effect/mob_spawn/human/corpse/charredskeleton,/turf/open/floor/plating/asteroid/basalt/lava_land_surface,/area/lavaland/surface/outdoors)

(1,1,1) = {"
abbbba
bbbcba
bcdcba
bcecba
bbcbba
abbbaa
"}
