"a" = (/turf/template_noop,/area/lavaland/surface/outdoors)
"b" = (/turf/closed/mineral,/area/lavaland/surface/outdoors)
"c" = (/turf/open/floor/plating/asteroid/basalt/lava_land_surface,/area/lavaland/surface/outdoors)
"d" = (/obj/structure/lattice,/turf/open/floor/plating/asteroid/basalt/lava_land_surface,/area/lavaland/surface/outdoors)
"e" = (/obj/effect/decal/cleanable/dirt,/turf/open/floor/wood,/area/lavaland/surface/outdoors)
"f" = (/obj/effect/decal/cleanable/dirt,/obj/effect/decal/cleanable/glass,/mob/living/simple_animal/hostile/tree,/turf/open/floor/wood,/area/lavaland/surface/outdoors)
"g" = (/obj/effect/decal/cleanable/blood,/obj/effect/decal/cleanable/dirt,/turf/open/floor/wood,/area/lavaland/surface/outdoors)
"h" = (/obj/structure/lattice,/obj/effect/mob_spawn/human/corpse/damaged,/turf/open/floor/plating/asteroid/basalt/lava_land_surface,/area/lavaland/surface/outdoors)
"i" = (/obj/effect/mob_spawn/human/corpse/damaged,/turf/open/floor/plating/asteroid/basalt/lava_land_surface,/area/lavaland/surface/outdoors)
"j" = (/obj/item/a_gift/anything,/obj/effect/decal/cleanable/dirt,/turf/open/floor/wood,/area/lavaland/surface/outdoors)
"k" = (/obj/structure/lattice,/obj/effect/decal/remains/human,/turf/open/floor/plating/asteroid/basalt/lava_land_surface,/area/lavaland/surface/outdoors)
"l" = (/obj/effect/decal/cleanable/dirt,/obj/effect/decal/cleanable/generic,/turf/open/floor/wood,/area/lavaland/surface/outdoors)

(1,1,1) = {"
aaabbbaaaa
abbcccbbaa
bcccdccbba
bcdefghccb
bcigjkedcb
abcheldccb
abccdccbba
abbcccbbaa
aaabbbaaaa
aaaaaaaaaa
"}
