"aa" = (/turf/template_noop,/area/template_noop)
"ab" = (/turf/closed/wall/r_wall,/area/ruin/space/has_grav/powered/scp_294)
"ac" = (/obj/structure/lattice,/turf/template_noop,/area/space/nearstation)
"ad" = (/turf/open/floor/plating/airless{icon_state = "platingdmg2"},/area/ruin/space/has_grav/powered/scp_294)
"ae" = (/obj/structure/lattice,/obj/item/soap,/turf/template_noop,/area/space/nearstation)
"af" = (/obj/structure/sink{dir = 4; pixel_x = 14},/obj/structure/mirror{pixel_x = 24},/turf/open/floor/plasteel/freezer/airless,/area/ruin/space/has_grav/powered/scp_294)
"ag" = (/obj/machinery/light/small,/turf/open/floor/plasteel/freezer/airless,/area/ruin/space/has_grav/powered/scp_294)
"ah" = (/turf/open/floor/plasteel/freezer/airless,/area/ruin/space/has_grav/powered/scp_294)
"ai" = (/obj/machinery/door/airlock{name = "Bathroom"},/turf/open/floor/plasteel/freezer/airless,/area/ruin/space/has_grav/powered/scp_294)
"aj" = (/obj/machinery/porta_turret/syndicate/energy/heavy{desc = "An energy blaster auto-turret designed to contain and terminate in case of a breach in security."; faction = "scp"; mode = 1; name = "emergency containment breach turret"},/obj/effect/turf_decal/box,/turf/open/floor/plasteel/dark{initial_gas_mix = "TEMP=2.7"},/area/ruin/space/has_grav/powered/scp_294)
"ak" = (/obj/effect/turf_decal/stripes/red/corner{dir = 9},/obj/effect/turf_decal/stripes/line{dir = 8},/obj/effect/spawner/trap,/turf/open/floor/plasteel/airless,/area/ruin/space/has_grav/powered/scp_294)
"al" = (/turf/open/floor/plasteel/airless/white/side{dir = 1},/obj/structure/table,/obj/machinery/microwave,/obj/machinery/light{dir = 1},/turf/open/floor/plasteel/airless,/area/ruin/space/has_grav/powered/scp_294)
"am" = (/turf/open/floor/plasteel/airless/white/side{dir = 1},/obj/structure/table,/obj/effect/turf_decal/stripes/line{dir = 4},/turf/open/floor/plasteel/airless,/area/ruin/space/has_grav/powered/scp_294)
"an" = (/turf/open/floor/plasteel/airless/white/side{dir = 1},/obj/machinery/chem_dispenser/scp_294,/turf/open/floor/plasteel/airless,/area/ruin/space/has_grav/powered/scp_294)
"ao" = (/turf/open/floor/plasteel/airless/white/side{dir = 1},/obj/machinery/vending/snack,/obj/effect/turf_decal/stripes/line{dir = 8},/turf/open/floor/plasteel/airless,/area/ruin/space/has_grav/powered/scp_294)
"ap" = (/turf/open/floor/plasteel/airless/white/side{dir = 1},/obj/structure/table,/obj/machinery/light{dir = 1},/turf/open/floor/plasteel/airless,/area/ruin/space/has_grav/powered/scp_294)
"aq" = (/obj/effect/turf_decal/stripes/red/corner{dir = 5},/obj/effect/turf_decal/stripes/line{dir = 4},/obj/effect/spawner/trap,/turf/open/floor/plasteel/airless,/area/ruin/space/has_grav/powered/scp_294)
"ar" = (/obj/effect/turf_decal/stripes/red/corner{dir = 9},/obj/effect/turf_decal/stripes/line{dir = 1},/turf/open/floor/plasteel/airless,/area/ruin/space/has_grav/powered/scp_294)
"as" = (/obj/effect/decal/cleanable/blood/old,/obj/effect/turf_decal/stripes/red/corner{dir = 8},/obj/effect/turf_decal/stripes/corner{dir = 4},/turf/open/floor/plasteel/airless,/area/ruin/space/has_grav/powered/scp_294)
"at" = (/turf/open/floor/plasteel/airless,/area/ruin/space/has_grav/powered/scp_294)
"au" = (/obj/effect/mob_spawn/human/corpse/nanotrasensoldier{id_job = "Level Three Clearance Guard"; name = "Clearance Level Three Officer"; oxy_damage = 136},/obj/effect/decal/cleanable/blood/old,/obj/effect/turf_decal/stripes/red/corner{dir = 4},/obj/effect/turf_decal/stripes/corner{dir = 8},/turf/open/floor/plasteel/airless,/area/ruin/space/has_grav/powered/scp_294)
"av" = (/obj/effect/turf_decal/stripes/red/corner{dir = 5},/obj/effect/turf_decal/stripes/line{dir = 1},/turf/open/floor/plasteel/airless,/area/ruin/space/has_grav/powered/scp_294)
"aw" = (/obj/structure/lattice,/obj/item/shard,/turf/template_noop,/area/space/nearstation)
"ax" = (/turf/open/floor/plasteel/airless/white/side{dir = 8},/turf/open/floor/plasteel/airless,/area/ruin/space/has_grav/powered/scp_294)
"ay" = (/obj/effect/mob_spawn/human/corpse/nanotrasensoldier{id_job = "Level Three Clearance Guard"; name = "Clearance Level Three Officer"; oxy_damage = 136},/obj/effect/decal/cleanable/blood/old,/turf/open/floor/plasteel/airless,/area/ruin/space/has_grav/powered/scp_294)
"az" = (/obj/effect/decal/cleanable/blood/old,/turf/open/floor/plasteel/airless,/area/ruin/space/has_grav/powered/scp_294)
"aA" = (/obj/effect/turf_decal/stripes/corner{dir = 8},/turf/open/floor/plasteel/airless,/area/ruin/space/has_grav/powered/scp_294)
"aB" = (/obj/effect/turf_decal/stripes/line{dir = 1},/turf/open/floor/plasteel/airless,/area/ruin/space/has_grav/powered/scp_294)
"aC" = (/obj/effect/turf_decal/stripes/red/corner{dir = 5},/turf/open/floor/plasteel/airless,/area/ruin/space/has_grav/powered/scp_294)
"aD" = (/obj/item/trash/plate,/turf/open/floor/plasteel/airless,/area/ruin/space/has_grav/powered/scp_294)
"aE" = (/turf/open/floor/plasteel/airless/white/side{dir = 4},/turf/open/floor/plasteel/airless,/area/ruin/space/has_grav/powered/scp_294)
"aF" = (/obj/effect/spawner/structure/window,/turf/open/floor/plating/airless,/area/ruin/space/has_grav/powered/scp_294)
"aG" = (/obj/structure/girder,/turf/open/floor/plating/airless,/area/ruin/space/has_grav/powered/scp_294)
"aH" = (/turf/open/floor/plating/airless,/area/ruin/space/has_grav/powered/scp_294)
"aI" = (/obj/structure/fluff/broken_flooring{icon_state = "corner"; dir = 8},/turf/open/floor/plating/airless,/area/ruin/space/has_grav/powered/scp_294)
"aJ" = (/obj/structure/table,/obj/item/trash/sosjerky,/turf/open/floor/plasteel/airless,/area/ruin/space/has_grav/powered/scp_294)
"aK" = (/obj/effect/turf_decal/stripes/corner{dir = 4},/turf/open/floor/plasteel/airless,/area/ruin/space/has_grav/powered/scp_294)
"aL" = (/obj/effect/turf_decal/stripes/red/corner{dir = 9},/turf/open/floor/plasteel/airless,/area/ruin/space/has_grav/powered/scp_294)
"aM" = (/obj/structure/table,/turf/open/floor/plasteel/airless,/area/ruin/space/has_grav/powered/scp_294)
"aN" = (/turf/open/floor/plasteel/airless/white/side{dir = 1},/obj/effect/spawner/trap,/turf/open/floor/plasteel/airless,/area/ruin/space/has_grav/powered/scp_294)
"aO" = (/obj/item/stack/rods,/turf/open/floor/plating/airless,/area/ruin/space/has_grav/powered/scp_294)
"aP" = (/obj/structure/fluff/broken_flooring{icon_state = "plating"; name = "broken plating"},/obj/structure/lattice,/turf/template_noop,/area/space/nearstation)
"aQ" = (/obj/structure/table_frame,/turf/open/floor/plasteel/airless,/area/ruin/space/has_grav/powered/scp_294)
"aR" = (/turf/open/floor/plating/airless{icon_state = "platingdmg1"},/area/ruin/space/has_grav/powered/scp_294)
"aS" = (/turf/open/floor/plasteel/airless/white/side{dir = 8},/obj/item/chair,/turf/open/floor/plasteel/airless,/area/ruin/space/has_grav/powered/scp_294)
"aT" = (/obj/structure/grille/broken,/obj/item/stack/rods,/turf/open/floor/plating/airless{icon_state = "platingdmg1"},/area/ruin/space/has_grav/powered/scp_294)
"aU" = (/obj/item/shard,/turf/open/floor/plating/airless{icon_state = "platingdmg1"},/area/ruin/space/has_grav/powered/scp_294)
"aV" = (/obj/structure/lattice,/obj/structure/fluff/broken_flooring{icon_state = "singular"},/turf/template_noop,/area/space/nearstation)
"aW" = (/obj/item/trash/cheesie,/turf/open/floor/plating/airless,/area/ruin/space/has_grav/powered/scp_294)
"aX" = (/turf/open/floor/plasteel/airless/white/side{dir = 4},/obj/structure/chair/office{dir = 4},/turf/open/floor/plasteel/airless,/area/ruin/space/has_grav/powered/scp_294)
"aY" = (/obj/item/stack/sheet/metal,/turf/open/floor/plasteel/airless,/area/ruin/space/has_grav/powered/scp_294)
"aZ" = (/obj/effect/mob_spawn/human/corpse/assistant,/obj/structure/table_frame,/turf/open/floor/plasteel/airless,/area/ruin/space/has_grav/powered/scp_294)
"ba" = (/obj/structure/grille/broken,/obj/item/shard,/obj/item/stack/rods,/turf/open/floor/plating/airless{icon_state = "platingdmg1"},/area/ruin/space/has_grav/powered/scp_294)
"bb" = (/obj/item/stack/rods,/turf/open/floor/plating/airless{icon_state = "platingdmg1"},/area/ruin/space/has_grav/powered/scp_294)
"bc" = (/obj/item/stack/tile/plasteel,/turf/open/floor/plating/airless,/area/ruin/space/has_grav/powered/scp_294)
"bd" = (/obj/structure/lattice,/obj/structure/fluff/broken_flooring{icon_state = "singular"; dir = 4},/turf/template_noop,/area/space/nearstation)
"be" = (/obj/structure/fluff/broken_flooring{icon_state = "pile"; dir = 4},/turf/template_noop,/area/template_noop)
"bf" = (/obj/item/trash/chips,/turf/template_noop,/area/template_noop)
"bg" = (/obj/effect/spawner/trap,/turf/open/floor/plating/airless{icon_state = "platingdmg2"},/area/ruin/space/has_grav/powered/scp_294)
"bh" = (/turf/open/floor/plasteel/airless/white/side{dir = 4},/obj/structure/chair/office{dir = 8},/obj/item/shard,/turf/open/floor/plasteel/airless,/area/ruin/space/has_grav/powered/scp_294)
"bi" = (/obj/effect/spawner/trap,/turf/open/floor/plasteel/airless,/area/ruin/space/has_grav/powered/scp_294)
"bj" = (/obj/effect/spawner/trap,/turf/open/floor/plating/airless,/area/ruin/space/has_grav/powered/scp_294)
"bk" = (/obj/structure/table_frame,/obj/effect/spawner/trap,/turf/open/floor/plasteel/airless,/area/ruin/space/has_grav/powered/scp_294)
"bl" = (/obj/item/stack/tile/plasteel,/turf/open/floor/plasteel/airless,/area/ruin/space/has_grav/powered/scp_294)
"bm" = (/turf/open/floor/plasteel/airless/white/side{dir = 4},/obj/item/chair,/turf/open/floor/plasteel/airless,/area/ruin/space/has_grav/powered/scp_294)

(1,1,1) = {"
aaaaaaaaaaaaabacaaacbgabaaaaaaaaaa
aaaaaaaaaaacabacaebgafabaaaaaaaaaa
aaaaaaaaacacabadacagahabaaaaaaaaaa
aaaaababababababababaiababaaaaaaaa
aaaaabajakalamanaoapaqajabacaaaaaa
acacabarasataAaBaKbiauavabacawaaaa
aaacabaxayazaLaNaCazaDaEaFacacacaa
aaaaaGbjaIaJaSataXaMaMbhaOadacaaaa
aaaaacaPaHaQaRblaEbkaMaHaTaUbgaaaa
aaaaaVacacbjaRaWbmaYaZadbabbacawac
aaaaaaaaacadacaHaEbcaRaHabacaaaaaa
aaaaaaaaacaaacaPadaRadacabacacaaaa
aaaaaaaaaaaaaaaabgbdaaaaaaaaaaaaaa
aaaaaabeaabfaaaaaaacaaaaaaaaaaaaaa
"}
