"aa" = (/turf/template_noop,/area/template_noop)
"ab" = (/obj/structure/lattice,/turf/template_noop,/area/space/nearstation)
"ac" = (/obj/structure/grille,/turf/open/floor/plating/airless,/area/ruin/space/has_grav/turretedoutpost)
"ad" = (/turf/closed/wall/r_wall,/area/ruin/space/has_grav/turretedoutpost)
"ae" = (/obj/structure/table/reinforced,/obj/item/stock_parts/cell/hyper,/obj/item/reagent_containers/food/drinks/bottle/vodka,/turf/open/floor/plasteel,/area/ruin/space/has_grav/turretedoutpost)
"af" = (/obj/structure/frame/computer,/turf/open/floor/plasteel,/area/ruin/space/has_grav/turretedoutpost)
"ag" = (/turf/open/floor/plasteel,/area/ruin/space/has_grav/turretedoutpost)
"ah" = (/obj/machinery/light{dir = 1},/turf/open/floor/plasteel,/area/ruin/space/has_grav/turretedoutpost)
"ai" = (/obj/machinery/door/airlock/external,/obj/effect/mapping_helpers/airlock/cyclelink_helper{dir = 4},/obj/structure/fans/tiny,/turf/open/floor/plating,/area/ruin/space/has_grav/turretedoutpost)
"aj" = (/obj/machinery/light{dir = 1},/turf/open/floor/plating,/area/ruin/space/has_grav/turretedoutpost)
"ak" = (/turf/open/floor/plating,/area/ruin/space/has_grav/turretedoutpost)
"al" = (/turf/open/floor/plating/airless,/area/ruin/space/has_grav/turretedoutpost)
"am" = (/obj/structure/table/reinforced,/obj/item/folder,/obj/item/radio,/turf/open/floor/plasteel,/area/ruin/space/has_grav/turretedoutpost)
"an" = (/obj/machinery/door/airlock/external,/obj/effect/mapping_helpers/airlock/cyclelink_helper{dir = 8},/obj/structure/fans/tiny,/turf/open/floor/plating,/area/ruin/space/has_grav/turretedoutpost)
"ao" = (/obj/machinery/porta_turret_construct,/turf/open/floor/plating/airless,/area/ruin/space/has_grav/turretedoutpost)
"ap" = (/obj/structure/filingcabinet,/turf/open/floor/plasteel,/area/ruin/space/has_grav/turretedoutpost)
"aq" = (/obj/machinery/light,/turf/open/floor/plasteel,/area/ruin/space/has_grav/turretedoutpost)
"ar" = (/obj/structure/chair/office/dark{dir = 8},/mob/living/simple_animal/hostile/russian/ranged/officer,/turf/open/floor/plasteel,/area/ruin/space/has_grav/turretedoutpost)
"as" = (/obj/structure/rack,/obj/effect/turf_decal/tile/neutral{dir = 1},/obj/effect/turf_decal/tile/neutral,/obj/effect/turf_decal/tile/neutral{dir = 4},/obj/effect/turf_decal/tile/neutral{dir = 8},/obj/item/gun/ballistic/revolver/nagant,/turf/open/floor/plasteel/dark,/area/ruin/space/has_grav/turretedoutpost)
"at" = (/obj/item/rack_parts,/obj/effect/turf_decal/tile/neutral{dir = 1},/obj/effect/turf_decal/tile/neutral{dir = 4},/turf/open/floor/plasteel/dark,/area/ruin/space/has_grav/turretedoutpost)
"au" = (/obj/item/rack_parts,/obj/machinery/light{dir = 1},/obj/effect/turf_decal/tile/neutral{dir = 1},/obj/effect/turf_decal/tile/neutral{dir = 4},/turf/open/floor/plasteel/dark,/area/ruin/space/has_grav/turretedoutpost)
"av" = (/obj/structure/rack,/obj/item/firing_pin,/obj/effect/turf_decal/tile/neutral{dir = 1},/obj/effect/turf_decal/tile/neutral{dir = 4},/turf/open/floor/plasteel/dark,/area/ruin/space/has_grav/turretedoutpost)
"aw" = (/obj/machinery/door/airlock/public/glass,/turf/open/floor/plasteel,/area/ruin/space/has_grav/turretedoutpost)
"ax" = (/obj/machinery/door/airlock,/turf/open/floor/plasteel,/area/ruin/space/has_grav/turretedoutpost)
"ay" = (/obj/structure/rack,/obj/effect/turf_decal/tile/neutral{dir = 1},/obj/effect/turf_decal/tile/neutral{dir = 4},/obj/item/weaponcrafting/receiver,/turf/open/floor/plasteel/dark,/area/ruin/space/has_grav/turretedoutpost)
"az" = (/turf/open/floor/plasteel/dark,/area/ruin/space/has_grav/turretedoutpost)
"aA" = (/obj/machinery/computer/apc_control,/turf/open/floor/plasteel,/area/ruin/space/has_grav/turretedoutpost)
"aB" = (/obj/structure/table/reinforced,/obj/item/clothing/head/ushanka,/obj/effect/turf_decal/tile/red,/obj/effect/turf_decal/tile/red{dir = 4},/obj/effect/turf_decal/tile/red{dir = 1},/obj/effect/turf_decal/tile/red{dir = 8},/turf/open/floor/plasteel,/area/ruin/space/has_grav/turretedoutpost)
"aC" = (/obj/item/rack_parts,/obj/effect/turf_decal/tile/neutral{dir = 1},/obj/effect/turf_decal/tile/neutral{dir = 8},/mob/living/simple_animal/hostile/russian/ranged/mosin,/turf/open/floor/plasteel/dark,/area/ruin/space/has_grav/turretedoutpost)
"aD" = (/obj/structure/table/reinforced,/obj/item/clipboard,/obj/machinery/light{dir = 1},/obj/item/radio,/turf/open/floor/plasteel,/area/ruin/space/has_grav/turretedoutpost)
"aE" = (/obj/machinery/power/apc{cell_type = /obj/item/stock_parts/cell/super; chargecount = 2.14748e+009; name = "Worn-out APC"; pixel_y = -24},/obj/structure/cable/white{icon_state = "0-2"},/turf/open/floor/plasteel,/area/ruin/space/has_grav/turretedoutpost)
"aF" = (/obj/structure/rack,/obj/effect/turf_decal/tile/neutral{dir = 1},/obj/effect/turf_decal/tile/neutral{dir = 8},/turf/open/floor/plasteel/dark,/area/ruin/space/has_grav/turretedoutpost)
"aG" = (/obj/structure/cable/white{icon_state = "1-2"},/turf/closed/wall/r_wall,/area/ruin/space/has_grav/turretedoutpost)
"aH" = (/obj/structure/rack,/obj/item/ammo_box/c9mm,/obj/effect/turf_decal/tile/neutral{dir = 1},/obj/effect/turf_decal/tile/neutral,/obj/effect/turf_decal/tile/neutral{dir = 4},/obj/effect/turf_decal/tile/neutral{dir = 8},/turf/open/floor/plasteel/dark,/area/ruin/space/has_grav/turretedoutpost)
"aI" = (/obj/machinery/door/airlock/public/glass,/turf/open/floor/plasteel/dark,/area/ruin/space/has_grav/turretedoutpost)
"aJ" = (/obj/structure/table/reinforced,/obj/structure/reagent_dispensers/peppertank{pixel_y = 32},/obj/item/reagent_containers/food/drinks/bottle/vodka,/turf/open/floor/plasteel,/area/ruin/space/has_grav/turretedoutpost)
"aK" = (/obj/structure/cable/white{icon_state = "0-2"},/obj/machinery/power/port_gen,/turf/open/floor/plating/airless,/area/ruin/space/has_grav/turretedoutpost)
"aL" = (/obj/structure/rack,/obj/item/clothing/head/helmet/swat,/obj/effect/turf_decal/tile/neutral{dir = 1},/obj/effect/turf_decal/tile/neutral{dir = 8},/turf/open/floor/plasteel/dark,/area/ruin/space/has_grav/turretedoutpost)
"aM" = (/obj/structure/rack,/obj/item/crowbar/red,/obj/item/paper/crumpled,/obj/effect/turf_decal/tile/neutral{dir = 1},/obj/effect/turf_decal/tile/neutral,/obj/effect/turf_decal/tile/neutral{dir = 4},/obj/effect/turf_decal/tile/neutral{dir = 8},/turf/open/floor/plasteel/dark,/area/ruin/space/has_grav/turretedoutpost)
"aN" = (/obj/structure/table/reinforced,/obj/item/pen/blue,/obj/item/grenade/smokebomb,/turf/open/floor/plasteel,/area/ruin/space/has_grav/turretedoutpost)
"aO" = (/obj/structure/chair/comfy/beige{dir = 4},/turf/open/floor/plasteel,/area/ruin/space/has_grav/turretedoutpost)
"aP" = (/obj/structure/bed,/obj/item/bedsheet/orange,/turf/open/floor/plasteel,/area/ruin/space/has_grav/turretedoutpost)
"aQ" = (/obj/structure/rack,/obj/item/grenade/chem_grenade/teargas,/turf/open/floor/plasteel/dark,/area/ruin/space/has_grav/turretedoutpost)
"aR" = (/obj/machinery/vending/clothing,/obj/structure/cable/white{icon_state = "1-2"},/turf/open/floor/plasteel,/area/ruin/space/has_grav/turretedoutpost)
"aS" = (/obj/structure/table/reinforced,/obj/machinery/light,/obj/item/camera_bug,/turf/open/floor/plasteel,/area/ruin/space/has_grav/turretedoutpost)
"aT" = (/obj/structure/table/reinforced,/obj/item/paper_bin,/turf/open/floor/plasteel,/area/ruin/space/has_grav/turretedoutpost)
"aU" = (/obj/machinery/porta_turret{installation = /obj/item/gun/energy/laser},/turf/open/floor/plating/airless,/area/ruin/space/has_grav/turretedoutpost)
"aV" = (/obj/structure/table/wood,/obj/item/reagent_containers/food/drinks/bottle/vodka{pixel_x = -4; pixel_y = 4},/obj/item/reagent_containers/food/drinks/bottle/vodka/badminka{pixel_x = 3},/turf/open/floor/plasteel,/area/ruin/space/has_grav/turretedoutpost)
"aW" = (/obj/structure/chair/office/dark,/mob/living/simple_animal/hostile/russian/ranged/trooper,/turf/open/floor/plasteel,/area/ruin/space/has_grav/turretedoutpost)
"aX" = (/obj/item/rack_parts,/obj/effect/turf_decal/tile/neutral,/obj/effect/turf_decal/tile/neutral{dir = 8},/turf/open/floor/plasteel/dark,/area/ruin/space/has_grav/turretedoutpost)
"aY" = (/obj/structure/rack,/obj/item/storage/belt/military,/obj/machinery/light,/obj/effect/turf_decal/tile/neutral,/obj/effect/turf_decal/tile/neutral{dir = 8},/turf/open/floor/plasteel/dark,/area/ruin/space/has_grav/turretedoutpost)
"aZ" = (/obj/structure/rack,/obj/effect/turf_decal/tile/neutral{dir = 1},/obj/effect/turf_decal/tile/neutral{dir = 8},/obj/item/gun/ballistic/shotgun/boltaction,/turf/open/floor/plasteel/dark,/area/ruin/space/has_grav/turretedoutpost)
"ba" = (/obj/structure/table/reinforced,/obj/item/paper/crumpled,/obj/effect/turf_decal/tile/red,/obj/effect/turf_decal/tile/red{dir = 4},/obj/effect/turf_decal/tile/red{dir = 1},/obj/effect/turf_decal/tile/red{dir = 8},/obj/item/switchblade,/turf/open/floor/plasteel,/area/ruin/space/has_grav/turretedoutpost)
"bb" = (/obj/structure/rack,/obj/effect/turf_decal/tile/neutral,/obj/effect/turf_decal/tile/neutral{dir = 8},/obj/item/suppressor,/turf/open/floor/plasteel/dark,/area/ruin/space/has_grav/turretedoutpost)
"bc" = (/obj/structure/rack,/obj/effect/turf_decal/tile/neutral,/obj/effect/turf_decal/tile/neutral{dir = 8},/obj/item/weaponcrafting/stock,/turf/open/floor/plasteel/dark,/area/ruin/space/has_grav/turretedoutpost)
"bd" = (/obj/structure/table/wood,/obj/machinery/light{dir = 8},/obj/item/sharpener,/turf/open/floor/plasteel,/area/ruin/space/has_grav/turretedoutpost)
"be" = (/obj/machinery/computer/station_alert,/turf/open/floor/plasteel,/area/ruin/space/has_grav/turretedoutpost)
"bf" = (/obj/machinery/door/airlock/maintenance_hatch,/obj/structure/cable/white{icon_state = "1-2"},/turf/open/floor/plating,/area/ruin/space/has_grav/turretedoutpost)
"bg" = (/obj/structure/cable/white{icon_state = "1-4"},/turf/open/floor/plasteel,/area/ruin/space/has_grav/turretedoutpost)
"bh" = (/obj/structure/cable/white{icon_state = "4-8"},/mob/living/simple_animal/hostile/russian,/turf/open/floor/plasteel,/area/ruin/space/has_grav/turretedoutpost)
"bi" = (/obj/machinery/light{dir = 4},/obj/structure/cable/white{icon_state = "1-8"},/turf/open/floor/plasteel,/area/ruin/space/has_grav/turretedoutpost)
"bj" = (/obj/structure/rack,/obj/effect/turf_decal/tile/neutral{dir = 1},/obj/effect/turf_decal/tile/neutral,/obj/effect/turf_decal/tile/neutral{dir = 4},/obj/effect/turf_decal/tile/neutral{dir = 8},/obj/item/surveillance_upgrade,/turf/open/floor/plasteel/dark,/area/ruin/space/has_grav/turretedoutpost)
"bk" = (/obj/machinery/porta_turret{installation = /obj/item/gun/energy/laser},/turf/open/floor/plating/airless,/area/ruin/space/has_grav/turretedoutpost)
"tK" = (/obj/effect/turf_decal/tile/red,/obj/effect/turf_decal/tile/red{dir = 4},/obj/effect/turf_decal/tile/red{dir = 1},/obj/effect/turf_decal/tile/red{dir = 8},/turf/open/floor/plasteel,/area/ruin/space/has_grav/turretedoutpost)

(1,1,1) = {"
aaaaaaaaaaaaaaaaaaaaaaaaaaaaaaaaaaaaababaaab
aaaaaaaaaaabaaaaababaaaaaaaaaaabaaabaaababab
aaaaaaaaaaabaaababaaacacacacacacacacacacacao
aaaaaaaaaaabababababacadadadadadadadadadadad
aaaaaaaaaaabaaaaaaaaacadaeaAbeafagahaiajakan
aaaaaaalalalalalalalacadamaragagagagaiakakan
aaaaalbkadadadadadadacadapaqagagagaEadadadad
aaaaaladadayatauavadadadadadawadaxaGadaKadbk
aaaaaladaCazazazazazadaBaJaDagadagaRadbfadac
aaaaaladaFazasaHazazaItKagagagadagbgbhbiadac
ababaladaLazbjaMazazaItKagaWagadaOagagaPadac
aaabaladaZazazazazaQadbaaSaTaNadaVagagaPadac
aaabaladadbbaXaYbcadadadadadadadbdagagaPadac
aaaaalbkadadadadadadaUalalalacadadadadadadac
aaababalalalalalalalalababaaacacacacacacacac
aaaaabababababaaababababaaaaabababaaaaaaabaa
aaaaaaabaaaaabaaaaaaaaabaaaaabaaabaaaaaaabab
aaaaaaaaaaaaaaaaaaaaaaaaaaaaabaaaaaaaaaaaaaa
"}
